X . . . . X . . X X M R R M R R R R R R R R R R R R R R R R 
R R R R R R R R R R P P M M M M M M M M M M R R R R R R R R 
R R R R R R R R R P P R M R M R R R R R R M R R R R R R R R 
R R R R R R R R P P R R R R R R R R R M R R R R R R R R R R 
R R R R R R R P P R R R R R R R R R R R R R R R R R R R R R 
R R R R R R P P R R R R R R R R R R R R R R R R R R R R R R 
R R R R R P P R R R R R R R R R R R R R R R R R R R R R R R 
R R R R P P R R R R R R R R R R R R R R R R R R R R R R R R 
R R R P P R R R R R R R R R R R R R R R R R R R R R R R R R 
R R P P R R R R R R R R R R R R R R R R R R R R R R R R R R 
R P P R R R R R R R R R R R R R R R R R R R R R R R R R R R 
P P R R R R R R R R R R R R R R R R R R R R R R R R R R R R 
P P R R R R R R R R R R X R R R R R R R R R R R R R R R R R 
R R R R R R R R R R R R R R R R R R R R R R R R R R R R R R 
R R R R R R R R R R R R R R R R R R R R R R R R R R R R R R 
R R R R R R R R R R R R R R R R R R R R R R R R R R R R R R 
R R R R R R R R R R R R R R R R R R R R R R R R R R R R R R 
R R R R R R R R R R R R R R R R R R R R R R R R R R R R R R 
R R R R R R R R R R R R R R R R R R R R R R R R R R R R R R 
R R R R R R R R R R R R R R R R R R R R R R R R R R R R R R 
R R R R R R R R R R R R R R R R R R R R R R R R R R R R R R 
R R R R R R R R R S R R R R R R R R R R R R R R R R R R R R 
R R R R R R R R R R R R R R R R R R R R R R R R R R R R R R 
R R R R R R R R R R R R R R R R R R R R R R R R R R R R R R 
R R R R R R R R R R R R R R R R R R R R R R R R R R R R R R 
R R R R R R R R R R R R R R R R R R R R R R R R R R R R R R 
R R R R R R R R R R R R R R R R R R R R R R R R R R R R R R 
R R R R R R R R R R R R R R R R R R R R R R R R R R R R R R 
R R R R R R R R R R R R R R R R R R R R R R R R R R R R R R 
R R R R R R R R R R R R R R R R R R R R R R R R R R R R R R 
